MMMMMMMMMMMMMMM
SCCCCCCCCCBCCCM
MMMMMMMCMMMMMCM
MCCCCCMCMCCCMCM 
MCMCCCMCMCCCCCM
MCMCMMMCMMMMMCM 
MCMCMCCCCCCCMCM
MCMCMCCCCCCCMCM
MCMCMMMMMMMMMCM
MCMCCCCCCCCCCCM
MCMMMMMMMMMMMCM
MCMCCCCCCCCCCCM
MCMMMMMMMMMMMCM
MCCCACCCCCCCCCM
MMMMMMMMMMMMMMM