MMMMMMMMMMMMMMM
SCCCCCCCCCBCCCM
MMMMMMMCMMMMMCM
MCCCCCMCMCCCMCM 
MCMCCCMCMCGCCCM
MCMCMMMCMMMMMCM 
MCMCMCCCCCCCMFM
MCMCMCCCCCCCMCM
MCMCMMMMMMMMMCM
MCMCCECCCCCCCCM
MCMMMMMMMMMMMCM
MCMCCCCCCDCCCCM
MCMMMMMMMMMMMCM
MCCCACCCCCCCCCM
MMMMMMMMMMMMMMM