MMMMMMMMMMMMMMM
SCCCCBCCCCCCCCM
MMMMMMMCMMMMMCM
MCCCCCCCCCCCMCM 
MCMCCCMCMCCCCCM
MCMCMMMCMMMMMCM 
MCMCMCCCCCCCMCM
MCMCMCCCCCCCMCM
MCMCMMMMMMMMMCM
MCMCCCCCCCCCCCM
MCMMMMMMMMMMMCM
MCMCCCCCCCCCCCM
MCMMMMMMMMMMMCM
MCCCACCCCCCCCCM
MMMMMMMMMMMMMMM